snooze - wotaku
Monster - Skillet
Hit the Road Jack - Ray Charles
The Rocky Road To Dublin - The High Kings
De$ert - Badass
Odo - Ado
Hoist the Colours - Colm R. McGuinness
Caramelldansen - Caramell
Valhalla Calling - Miracle of Sound
Primo Victoria - Sabaton
Usseewa - Ado
vendetta! - MUPP
Murder In My Mind - Sped Up - Kordhell
Green Onions - Booker T. & The MG's
Mambo No. 5 (a Little Bit of...) - Lou Bega
Crocodile Rock - Elton John
Let Me Blow Ya Mind - Eve
Little Girl Gone - CHINCHILLA
紅蓮華 - LiSA
Fluorescent Adolescent - Arctic Monkeys
Industry Baby x ET Rework - Vemouz
Drink - Alestorm
Take Me Out - Franz Ferdinand
Heist - Noisestorm
Fading Flower - Yuna
POP/STARS - K/DA
Wudidong - Higher Brothers
Daisy - Ashnikko
Wild Side - ALI
Start a Riot - Duckwrth
遥か彼方 - Asian Kung-Fu Generation
Toxicity - System Of A Down
GDFR (feat. Sage the Gemini & Lookas) - Flo Rida
Purple Lamborghini (with Rick Ross) - Charted
New Shoes - Paolo Nutini
Pencil Full of Lead - Paolo Nutini
Toxic - Britney Spears
Fast (Motion) - Saweetie
Crab Rave - Noisestorm
I'm an Albatraoz - AronChupa
Antihero - Noisestorm
Diamonds + And Pearls - DPR LIVE & peace.
Ashura-chan - Ado
These Boots Are Made For Walking - Nancy Sinatra
Good Times - Mando Diao
Boom Boom - John Lee Hooker
Bury Me With My Guns On - bobaflex
Burn Baby Burn - Kid Cudi
How Bad Can I Be? - Ed Helms
Mad World - FullyIncorruptible
Nyan Cat Theme - Digidudes
Walk The Dinosaur - Was (Not Was)
Četrnaest Palmi - Daleka Obala
I'm Dreaming of a Diamond Sword - Tobuscus
Gasolina - Daddy Yankee
夜に駆ける - YOASOBI
Cotton Eye Joe - Rednex
Thunderstruck - AC/DC
Raindrops Keep Falling on My Head - Rerecorded - B J Thomas
Satisfaction - David Guetta
Mona - Craig McLachlan
Numbers (I Can Only Count to Four) - Psychostick
Back In Black - AC/DC
Flamenco (feat. Rage) - Timmy Trumpet
Glitter & Gold - Barns Courtney
Awake and Alive - Skillet
